wanderer -- странник
necklace -- ожерелье
to excavating -- копать
gravesite -- могила
humble -- скромный
bygone -- прошлое
comparatively -- сравнительно
namely -- именно
consecutive -- последовательный
baptised -- крестился
bewildered -- сбитый с толку, озадаченный
quarry -- карьер
betrothal -- обручение
regain -- восстановить
moat -- ров
situated -- расположенный
plain -- равнина
mounds -- курганы
sods -- дерн
timber -- древесина
knot -- узел
eyehole -- глазок
walking-stick -- трость
howled -- выть, реветь
scouled -- ругать
infancy -- младенчество
peculiarities -- особенности, специфичность, странность
betrothed -- невеста, обрученный
whereof -- изз которых
abundance -- избыток
tinkled -- звонить
sly -- хитрый, лукавый
mischief -- зло, вред
thralls -- рабы
shed -- сарай
calves -- телята
fastened -- закрепленный
leave -- позволения
strap -- ремень
outpassed -- превзойден
russet -- красновато-коричневый, простой, деревенский
whence -- откуда
bewitched -- заколдованный, очарованный
like -- нравиться, подобно, хотеть
gasped -- ахнул
Aye -- да
trembling -- дрожащий
objected -- возразил
silly -- глупый
hapr -- арфа
govern -- управлять
merry -- веселый
weedy -- слабый, тощий
dart -- стрела, дротик
handsomet -- самый красивый
hatched -- вылупился
swan -- лебедь
implored -- умолял
stripling -- юноша
growl -- рычание, грохот
cub -- детеныш
liver -- печень
wench -- девка
whilst -- пока, в то время как
gliding -- скользя, скольжение
bending -- изгиб, изгибаясь
willow -- ива
unsealed -- распечатана, вскрыта
blissful -- блаженный
beakers -- кубки
thrust -- засовывать, толкать
clung -- цепляться
scheming -- коварный
lineage -- происхождение
compel -- принуждала
mergint -- слияние
floes -- льдины
dwelt -- обитал, жить
club-foot -- косолапость
limping -- хромая
drawbridge -- подъемный мост
stead -- место, земельный участок
sowing -- посев
to fret -- волноваться
whither -- куда
ill -- больной, плохой
errand -- поручение
to croak -- каркать
raven -- ворона
brethren -- братья
foresight -- предвидение
fore-or-dained -- предопределенный
betrothed -- невеста
leavings -- остатки
hot-headed -- вспыльчивый
begone -- ушел, пойти вон, уйди
wager -- пари, ставка
muse -- размышление, задумчивость, вдохновение
tilted -- наклонился
surge -- волна
broad -- широкий
endlessly -- бесконечно
grinning -- ухмыляющийся
whereon -- после чего
unwillingly -- неохотно
doubtfully -- сомнительно
farther -- дальше
settled -- улаженный, уладил, решил
perchance -- быть может
yonder -- там, вон там
hazard -- риск
scenery -- пейзаж
vexed -- раздосадованный
temper -- характер, самообладание
taunt -- насмешка
flushed -- покраснел
gripped -- схватился
shaft -- стержень, ручка
insult -- оскорбление
jeer -- издеваться
stung -- ужаленный
niddering -- презренный
felled -- сбил
steersman -- рулевой
hoisted -- подняла
sail -- паруса
ought -- должен
malice -- злоба
dismounted -- спешился
mounds -- насыпь
bushes -- кусты
the brute -- животное, скотина
bid -- объявить, попросить, велеть, предлагает
gorge -- ущелье
dense -- плотный, густой
springing -- прыгающий
rankled -- мучить, причинять боль
sprang -- прыгали
scrub -- кустарник, кусты
matted -- спутанные
boughs -- ветки
firs -- ели
mingled -- смешанные
gloomy -- хмурый
glade -- поляна
whirling -- кружащийся
soilless -- беспочвенная
tops -- вершины
rotted -- сгнил
casting -- бросаясь
purposing -- цель
hound -- гончая
pruposing -- намереваясь
halted -- остановился
crunching -- хрустящий
crunch -- хруст
disturbed -- потревоженный, встревоженный
farmished -- голодный
reared -- поднялся
hind -- задние
towered -- возвысился
outstretched -- растянулись, протянутый
pulp -- мякоть
upreared -- приподнятый
sniffing -- нюхая
hurled -- швырнул, бросил
champed -- грызть
bethought -- задумался
splinter -- щепки, осколки, раскалываться
trunk -- ствол
sped -- ускорился
ranks -- ряды
flutter -- порхать, биться
presently -- вскоре
fainted -- падать в обморок
untwisting -- раскручивая
pour -- налить, лить, литься
poured down -- вылила
hither -- сюда
frame -- каркас
poles -- столбов
niche -- приют
sore -- тяжко, больно
brow -- бровь, лоб, вид, наружность
fares -- дела, быть, поживать
mean -- подлый
draws on -- приближается, опирается на
handsome -- красивый, статный
beguile -- обманывать, развлекать
broth -- бульон, суп
spoon -- ложка
handle -- ручка
longways -- вдоль
shelter -- укрытие
stung -- ужалить
wolfhounds -- волкодавы
baying -- лай
quelled -- подавленны, сокрушены
fosterling -- подопечный
quarrelled -- поссорился(ась)
grief -- горе
gale -- буря
mounted -- верхом
eagerly -- с нетерпением, горячо
clad -- одетый
girt -- опоясанный
stared -- смотрел
gloomily -- мрачно
restrain -- сдерживать
shrank back -- отпрянул
gaily -- радостно
wisp -- клочок
hay -- сено
heir -- наследник
cattle -- скот
embracing -- обнимая
curtsied -- реверанс
bade -- велел
morrow -- завтра
decreed -- постановил
sourly -- кисло
adornment -- украшение
robbed -- лишило
pondering -- размышлял, обдумывал
humbly -- смиренно, робко
forthwith -- немедленно
tiding -- весть, новости
stool -- табуретка
brooding -- задумчивый
folly -- глупость
slighting -- пренебрежение
grumbled -- ворчал
suffered -- страдал, позволил
grasp -- хватка
recited -- читал
steady -- твердый, стойкий
fats -- толстит
kite -- летающий змей, коршун
overtire -- переутомляться
hence -- отсюда, с этих пор
urged -- побудился
latter -- последний
bide -- ждать
aught -- что-то, нечто, ничего
mayhap -- может быть
dinted -- помятый
soiled -- грязный
mail -- кольчуга
cross -- крест
naught -- ничего
shells -- ракушки
ere -- перед, до
sacrilege -- святотатство, кощунство
strengthless -- непрочный, бессильный
tinder -- сухое дерево
spared -- пощадил, свободный
bridegroom -- жених
spade -- лопата
for aught i know -- насколько мне известно
sparks -- искры
seal -- тюлень, печать, клеймо
slabs -- плиты
watern-worn -- истертые водой
soil -- почва
sfited -- просеянный
tomb chamber -- гробница
sloped -- наклон, наклоненный
drainage -- осушен
labour -- труд
clambered -- карабкался
scratheced -- поцарапал
elbow -- локоть
trunk -- ствол
shroud -- саван, пелена
scourge -- бич, плеть
crook -- крюк, скрючивать, изгибать
shepherd -- пастух
knob -- ручка
stiff -- жесткий, тугой, твердый
feather -- перо
clad -- одетый, одевать
mild -- мягкий, тихий
looped sceptre -- петлевой скипетр
burnished -- полированный
pouch -- мешочек, сумка
sap -- сок
sawn -- распилен
lid -- крышка
pegged -- привязанный
preserved -- сохранила
bend down -- наклонились
grizzled -- седой
tinged -- окрашены
crumbled -- рассыпался
chin -- подбородок
dinted -- помятый
beetles -- жуки
tugged -- дернул
stout -- крепкий
snathed -- схватил
threateningly -- угрожающе
crest -- герб, гребень, холм, пик
drawn -- притянутый
thence -- оттуда
goad -- побуждение
bassin -- таз, чаша
crops -- урожай, посевы
pines -- сосны
beheld -- созерцал
surmount -- преодолевать, увенчивать
desolate -- заброшенный, запустелный
features -- особенности, черты лица
hue -- оттенок, окрашивать
earnestly -- серьёзно
thereafter -- после этого
condemned -- осуждён
doom -- рок, гибель
strands -- пряди
sever -- разрывать, разорвать
sow -- сеять
everlasting -- вечный
beckon -- манить, кивать
longing -- тоска
astir -- на ногах
forthcoming -- предстоящий, грядущий
proffer -- предлагать
twist -- крутить, сплетать, искривлять
heed -- внимание
fnodling -- ласкание
save -- кроме
woe -- горе, несчастье, беды
rites -- обряды
continually -- постоянно
avail -- воспользоваться, выгода, польза
clasping -- сжимая
homage -- дань уважения, почтение
morn -- утро
trumpeters -- трубачи
kine -- корова
wool -- шерсть
grip -- схватить
staggered -- ошеломленный
troth-breakers -- разбойники
depart -- отходить, отступить
resembled -- напоминал
repent -- покаяться, каяться
wickedness -- злоба
thenceforward -- впредь
mischief -- вред
in due course -- в должное время
depose -- свергать, низложить, смещать
blameless -- невинный
halved -- поделенный пополам
manned -- укомплектованный людьми
substance -- содержание, сущность
misled -- введенный в заблуждение, сбитый с толку
outlaw -- изгнать, объявить вне закона
ascertained -- установлено
wreak -- сеять
to abide -- соблюдать
fey -- обреченный
gentleness -- мягкость
headlong -- стремглав
pledge -- приносить присягу, залог, обещать
crabs -- обрывки
hover -- парение, зависать, ожидание
sorely -- очень, жестоко
crouch -- присесть
feeble -- слабый
scarcely -- едва ли
ghastly -- страшно, ужасно
immovable -- неподвижный
forefather -- предок
hilt -- рукоять
prevails -- преобладает
preaching -- проповедь
shalt -- будет
glared -- впился взглядом
wrathfully -- гневно
thereby -- тем самым, таким образом
rede -- разгадать
solemnly -- торжественно
forebode -- предчувствие
embark -- садиться, погрузиться
hearken -- слушать
unreadiness -- неготовность
vessel -- судно, сосуд, резервуар
abreast -- рядом, в ряд
sails -- паруса
flight -- бегство
oars -- вёсла
grappling irons -- крюки
sighting -- прицеливание
fierce -- яростный, жестокий, свирепый
fray -- драка, скандал
grapple -- схватиться, бороться
fared the worst -- дела обстояли хуже всего
bulwark -- бастион, оплот, фальшборт
waist -- талия, шкафут
hack -- взломать, рубить
clove -- раскалывать
prow -- нос
wont -- привычка, обыкновение
obedience -- послушание
to hurl -- швырять
wrestle -- бороться
girdle -- пояс
strove -- стремился
swift -- быстро
favouring -- попутный
multitude -- множество, толпа
orphans -- сироты
woo -- ухаживать, добиваться
thither -- туда
tarry -- медлить
alas -- увы
wail -- вопль, войя
undermost -- самый нижний
toil -- трудиться
mourn -- оплакивать, печалиться
a flight of steps -- лестничный пролёт
admit -- признавать, допускать
bolted -- прикручен
barred -- перекрытая
den -- логово, притон, убежище
rushes -- камыши
swell -- зыбь, набухать, разбухать, раздувать
to bid you farewell -- попрощаться с тобой
host -- хозяин, войско, толпа
scourge -- бичевать, наказывать
hearken -- слушать, слушай
forbade -- запретил
bred -- воспитан, развит, разведен
heritage -- наследство
chant -- воспевать
dull -- тусклый
aloft -- наверху, в воздухе, ввысль
chapel -- молельня, часовня
dissent -- несогласие
foregoing -- вышеизложенное, вышеупомянутый, иногда: отказ
outdone -- превзойдён
to fashion -- вылепить
champ -- чавкать
jaws -- челюсти
hog -- свинья
sane -- в своём уме, здравомыслящий
glaring -- вопиющий, яркий
ewe -- овца
lamb -- ягненок
livelihood -- средства к существованию
filthy -- грязный
strode -- шагать
affronts -- оскорбляет
fold -- складывать, сложить
wren -- крапивник
twitter -- щебетать, чирикать
thatch -- солома
drew -- обнажил
hew -- рубить, высекать
rattle -- грохот, греметь, стук
writhe -- корчиться
shatter -- разбить, разрушать
askance -- искоса
meads -- луг
to wreck -- разрушать
gory -- кровавый, окровавленный
behold -- смотри, созерцай
boon -- благо, дар, благодеяние
rend -- разрывать, раздирать
smote -- ударил
blunt -- тупой, притупленный
compelled -- принудил, вынужденный
trifle -- мелочь, пустяк
erred -- ошибся
wayward -- своенравный, сбившийся с пути
apt -- подходящий, склонный
weakling -- слабак
hewn off -- срезанный
glint -- блеск, отблеск
betwixt -- между
unclasp -- расстегивать
withstood -- выдержал
plot -- сюжет, заговор
charge -- заряд, заряжать, обязанности
oblivion -- забвение
brow -- лоб
gulf -- бездна, залив, пропасть
overlook -- игнорировать, проглядеть, возвышаться
shield -- щит, экран
well-knit -- крепко сложенный
slender -- стройный, тонкий
joint ruler -- сопровитель
byname -- прозвище
selfsame -- тот же самый
swung round -- развернулся
attire -- наряд, платье
ripple -- рябь, волнистость
pucker -- морщиться
hermit -- отшельник
exasperation -- раздражение
renounce -- отказаться
rogues -- мошенники
spittle -- слюна
bare -- голый, обнажить
witty -- остроумный
befouled -- загаженный, испачканный
thoughtful -- задумчивый, заботливый
ransom -- выкуп
thereon -- на нём, вслед за тем
slit -- разрезать, щель, разрез
severe -- серьезный
indignant -- возмущенный
withstood -- выдержал, выдерживать, противостоять
foully -- нечестно, предательски, жестоко
saluted -- приветствовал, отдал честь
heathen -- языческий, варварский
attitude -- отношение
plead -- умолять, просить, признавать, защищать
welfare -- благосостояние
strive -- стремиться
totter -- шататься
begotten -- рождённый
beget -- породить, рождать
bluntly -- прямо
suitors -- женихи, поклонники
hag -- ведьма, карга
throve -- процветать, преуспеть
concession -- уступка, концессия
pious -- благочестивый, набожный
bargain -- торговаться, сделка
tramp -- бродяга
antechambers -- вестибюли
muster -- собрать
writ -- предписание
fable -- басня, сказка
scorn -- презрение
seal -- запечатывать, скреплять
preceded -- предшествовать, быть впереди
prey -- добыча, охотиться, жертва, терзать
prostrate -- простертый, поверженный, распростерый
thereupon -- после этого
dismiss -- уволен, распускать, отпускать
grovelings -- пресмыкательства
grovel -- пресмыкаться, унижаться
bribe -- взятка, подкуп
clad -- одетый
halt -- остановиться
reek -- воняет
sham -- притворство
confine -- ограничивать, держать взаперти
leap -- прыгнуть, ухватиться
idle -- праздный, пустой, бездельничать
jest -- шутка
aloof -- в стороне, отчуждение
beady -- бусинки
robin -- малиновка
courtier -- придворный
emergency -- чрезвычайная ситуация
arise -- возникать, появляться
pickings -- добыча
reckon -- считать, принять во внимание
ramparts -- бастион
dazzle -- ослеплять
illustrious -- прославленный, известный
yard -- площадка
furnish -- снабжать, обставлять, меблировать
condemn -- осуждать, приговаривать
felons -- уголовники
three-score -- шестьдесят
stationed -- размещены
tame -- приручить, укрощать, ручной
ease -- простота, легкость, облегчать, ослаблять, потравить
whimper -- хныканье, скулить
foam -- пениться, вспениться, мыло
maim -- калечить, увечить, травма
dissect -- вскрыть
pinch -- щепотка
powder -- порошок, пудра, порох
stalk -- стебель
sacrament -- причастие, таинство
administer -- управлять
ministering priest -- священнослужитель
ordain -- посвящать, предопределен
unfit -- непригодный
pointed -- заострённый, острый
chin -- подбородок
notwithstanding -- несмотря на, вопреки
disfigurement -- обезображивание
tonsured -- постриженный
gibber -- бормотать
confessor -- духовник
consolation -- утешение
adherence -- приверженность, приверженец, сторонник
tend -- ухаживать, заботиться
gorge -- ущелье, горло, теснина
starling -- скворец
upright -- прямой, честный
gabble -- болтать, бормотать
oppress -- угнетать, притеснять
bestow -- даровать
dumb -- тупой, немой
wherewith -- с чем
aspire -- стремиться
mutilate -- калечить, уродовать, увечить
whining -- нытье
fretful -- раздражительный
bar -- решётка
noose -- петля
swoon -- обморок, потерять сознание
fetter -- оковы, сковывать
fervently -- страстно, горячо
hitherto -- до сих пор
wanting -- желание, нуждающийся, отсутствующий
to perish -- погибнуть
pastoral -- пастушеский
staff -- посох, жезл
attendant -- провожающий, сопутствующий
tumult -- суматоха, смятение
adversaries -- противники
stave -- посох
belaboring -- трудолюбивый, колотить
adherent -- приверженец, сторонник
brawny -- мускулистый
spat -- плюнул, легкий удар, ссориться
cripple-- калечить, изувечить
sweet-natured -- добродушный
shone -- сиял
bosom -- грудь
vessel -- сосуд
porter -- портье, носильщик
accedes -- присоединяется, соглашаться
sting -- жало
nod -- кивок, кивнуть
flavour -- аромат, запах
bid good-bye -- попрощаться
charioteer -- возница
repulse -- отпор, отвергать, отталкивать
obstinate -- упрямый
stammer -- заикаться, заикание
exalted -- возвышенный
battering -- избиение
thorough -- тщательный, обстоятельный
gossip -- сплетни
evidently -- очевидно, видимо
attend -- посещать, присутствовать
chamberlains -- камергеры
ante-room -- прихожая
tryst -- свидание
hose -- чулки, рукав
jar -- банка, кувшин, дисгармония, раздражать
deck -- украшать, палуба
fie -- фу, тьфу
recline -- полулежать, откидываться
hued -- окрашенный
apparel -- одета, обличена, украшена
array -- одевать, облачать, украшать
sullen -- угрюмый, мрачный
to settle -- разрешить, урегулировать
to scowl -- хмуриться
wits -- остроумие
scarce -- скудный, едва
gaud -- безвкусный, мишура
draught -- глоток
dash -- бросаться
spill -- проливать, разливать
have done -- перестаньте
huckster -- торговаться
to revile -- ругать, поносить, оскорблять
hiccough -- икота
whip -- хлыстать, взбить, стегнуть
hector -- грубить, оскорблять, напугать
devour -- пожирать, поглощать, съесть
allay -- успокаивать
bent -- согнутый, изогнутый, кривой
buffet -- ударять, бить
clash -- столкновение
spring -- исходят, возникать, происходить
scent -- запах, душить
unscathed -- невредимый
wellnigh -- почти, ну ладно
diocese -- епархия
rustle -- шорох, шелест, шелестеть
instant -- мгновение, момент
tress -- коса, локон
hoarsely -- хрипло
swam -- плавал
hypocrite -- лицемер
offal -- потроха
slantwise -- косо, под уклон
forsworn -- отрекшийся от присяги, отрекшийся
signet -- печать, печатка
combe -- расчесывать
tangle -- запутывать, усложнять
undid -- расстегнул, развязывать
awry -- криво
clearness -- ясность
whosoever -- кто бы ни
effeminates -- женоподобный
uneasy -- беспокойный, неудобный, неловкий
pitfalls -- ловушки
warrant -- предписание, ордер, основание
shrewd -- проницательный, умный
banishment -- изгнание
emerge -- появляться, возникать, выходить
unscathed -- невридимый
singe -- опалить, ожог
molest -- приставать
convey -- передавать, сообщать, выражать
token -- знак, признак
throng -- толпа
vouchsafe -- удостаивать, соизволять
reprove -- порицать
foible -- слабость, слабый, недостаток
forsaken -- покинутый, брошенный
henceforth -- отныне, впредь
encouragement -- поощрение, ободрение
titter -- хихикать
sufficient -- достаточный
remedied -- исправлено
venture -- риск, осмелиться, отважиться
guard -- осторожность, бдительность
means -- способ
congregation -- собрание
proclaimed -- провозглашён
avow -- признаться
steed -- конь
warlike -- воинственный
descendant -- потомок
cataract -- поток
assailed -- подвергнуты нападению
befits -- подходит
trinket -- безделушка
fetch -- принести, получать, выбирать
mare -- кобыла
brought up -- воспитанный
precede -- предшествовать
regiments -- полки
peculiar -- специфичный, своеобразный
hoot -- улюлюкать, гудеть, кричать, свистеть
to bar -- преградить
winding -- извилистый, обмотка
aisle -- ряд, проход
apse -- апсида
rail -- рельс, перила, поручни, перекладина
censer -- кадило
incense -- благовония
prompting -- побуждение
sour -- кислый
squint -- косоглазие, щуриться
pat -- погладить, похлопать
sacrament -- причастие, таинство
resounding -- звучный, гулкий
complexion -- цвет лица
brush -- столкновение
fare -- быть, происходить, случаться
longed -- желанный
careless -- беспечный, неосторожный, небрежный
pretence -- притворство
glower -- недовольство (have an angry or sullen look on one's face; scowl)
perquisites -- привилегии
pertain -- относиться, принадлежать
render -- оказывать, отдавать, исполнять
favour -- услуга, благосклонность
preferment -- продвижение по службе
archly -- лукаво
goodness -- доброта, хорошее качество
humility -- смирение
scratch -- царапать
cheerful -- жизнерадостный
breed -- порода, разводить, порождать
wooly -- мохнатый
grease -- жир, сало
concern -- беспокойство, относиться, касаться
concerning -- относительно, касательно
mutinous -- мятежный
wind -- ветер, слух, намек, чуять
srife -- борьба, раздор
blindfold -- с завязанными глазами, вслепую
precipice -- пропасть
street-bred -- беспризорные
retain -- сохранить, удерживать
peach -- персик
swarthy -- смуглый, темный
housed -- размещенный
conduct -- проводить, руководить, вести
feasible -- достижимый, осуществимый
grove -- роща
threefold -- тройственный
couple -- пара, соединяться, связывать
cling -- цеплять, облегать
tint -- оттенок, краска, тонкий
conjured -- сотворенный
superstitious -- суеверный
affianced -- помолвлен, обручена
presume -- позволять себе, предполагать, допускать
rating -- выговор
disarrange -- беспорядок, расстраивать
embalmed -- забальзамированный
vigorous -- сильный, энергичный
cur -- собака, дворняжка
baggage -- плутовка
foul -- грязный, подлный, гнусный
treason -- измена, предательство
anointed -- помазанник
sundry -- всякая всячина, разый, различный
flaxen -- льняной, светло-желтый
sober -- трезвый
stolid -- флегматичный, бесстрастный, тупой, вялый
canvass -- холст, собирать, обсуждать
scum -- отбросы, сволочь, нечисть
sheath -- оболочка, обшивка, ножны
slope -- склон
surge -- всплеск, хлынуть, вздыматься
charge -- натиск, атака, нападение
corn -- пшеница
sickle -- серп
shearing -- срез, сдвиг
stray -- бродить, плутать
scale -- шкала, масштаб, размер, взбираться
scales -- весы
huddled -- сбившийся в кучу
roll -- катиться, крен, вращение
trod -- ступал, тропинка
grip -- схватить, зажим, тиски
petty -- мелкий, небольшой
stake -- ставка, доля
composure -- хладнокровие, спокойствие
fugitive -- беглец, беженец
parley -- переговоры
unmolested -- бесприпятственный
undertaking -- обязательства, предприятие, соглашение
sickly -- болезненный, слабый
frescoed -- расписанный фресками
condemnation -- осуждение, приговор
signify -- обозначать, означать, значить
imp -- чертенок
presided -- председательствовал
hare -- заяц
uncondemned -- неосуждённый
insolence -- дерзость, наглость
detain -- задерживать, удерживать
hustle -- суетиться, торопиться
befell -- случилось
drape -- драпировать, украшать тканями
accustom -- привыкать, приучать
mannikin -- карлик
to wit -- а именно, то есть
altogether -- вообще, совсем, совершенно
seldom -- редко
sentence -- приговор
safe-conduct -- охранная грамота
snarl -- зарычать, рычать, ворчать
outbreak -- вспышка, восстание, волнение
constitute -- составляют, составлять, образовывать
ere long -- скоро
strait -- пролив, узкий
marvel -- удивляться, изумляться
forgiveness -- прощение
cradle -- колыбель, начало, люлька
tormentor -- мучитель, истязатель
plentiful -- обильный, изобильный
motioned -- подал знак
smirch -- очернять, пачкать, позор, пятнать
beset -- окруженный, осаждать, теснить
consort -- супруг, супруга
mortified -- омертвевший
deceive -- обмануть, вводить в забдуждение
dent -- вмятина, впадина, помятый
beak -- клюв
wirthe -- корчиться, терзаться, извиваться
puff -- слойка, пыхтеть
fiend -- злодей, демон
keen -- острый, тонкий, увлеченный
harbinger -- предвестник, предвещать
crucifie -- распять
baffle -- ставить в тупик, сбивать с толку
smuggle -- переправлять, провозить контрабандой
shorn -- стриженный, срезанный
vouch -- ручаться
orb -- сфера
clemency -- снисходительность, милосердие
afoot -- в движении, в пути, в действии
cramp -- стеснять, зажим, мешать, ограничивать
suppress -- подавлять, пресекать, сдерживать
lo -- вот
clang -- лязг
hint -- намекать, совек
brew -- заваривать, приготовлять, замышлять
knave -- лжец, плут, негодяй
anon -- тотчас, вскоре, скоро
hinge -- петля, стержень, крюк
yawn -- зевать, зазор, зиять
snare -- ловушка
hereafter -- в дальнейшем, в будущем
sport -- забава, развелечение
seethe -- бурлить, кипеть, варить
shriek -- визг
booty -- трофеи, добыча
portable -- переносимый, портативный, передвижной
appeas -- успокоить, умиротворить
afar -- издалека, издали
dispatch -- отправлять, посылать
prowl -- бродить, рыскать
stir -- помешивать, размешивать, движение, шевелить
smother -- душить, подавлять, задохнуться
hale -- здоровый, тащить, тянуть
steadily -- стабильно, неуклонно
intently -- пристально
suspense -- ожидание, неизвестность, неопределенность
meanest -- самый подлый
beggared -- нищий
breadth -- ширина, широта
barleycorn -- ячменное зерно
shrivel -- сморщиваться, высыхать, скрючиваться
everlastingly -- навсегда
poverty -- бедность, нищета
heretofore -- до сих пор
pronounce -- произносить, выговорить, объявить
wonderment -- изумление
rede -- рассказ, объяснение, разгадка, совет
prickle -- колоть, прокалывать
thick -- густой, хриплый, невнятный
spilt -- пролитый
lap -- колени, жадно пить, лакать
gorge -- глотка
rancid -- протухший
forsooth -- правда
dregs -- отбросы
stews -- тушеное мясо
drunkard -- пьяница
torrent -- поток
invective -- оскорбление
quail -- дрогнуть, струсить
boisterous -- шумный, неистовый, бурный
dower -- приданное, вдовья часть наследства
rod -- розга, штанга, стержень
fang -- клык, зуб
whelp -- отродье, щенок
repel -- отталкивать, отражать, отгонять
befall -- случиться, происходить
deputy -- заместитель, представитель
vineyards -- виноградники
estates -- поместья
marshal -- маршал, размещать, выстраивать
rent -- дыра, разрыв
seam -- шов
disinter -- выкапывать, раскапывать, отрывать
double -- двойной, двойник
doorpost -- дверной косяк
lean -- наклонять, опираться
pinch -- щепотка, крайняя нужда
bays -- бухты
harbor -- гавань
disembark -- высадиться, высаживать
content -- содержание, довольствоваться
consideration -- рассмотрение, соображение
inquire -- спрашивать, исследовать, узнавать
commoner -- простолюдин
insurrection -- восстание
nimble -- проворный, ловкий, гибкий
sightless -- незрячий
burden -- груз
harper -- арфист
secrecy -- секретность, тайна, скрытность
hopeful-minded -- полный надежд
outright -- прямо, сразу
unloose -- освободиться, отвязывать
fee -- платёж, плата, взнос
quay -- пристань, причал, набережная
afflict -- огорчать, поражать, причинять боль
becalmed -- штиль, успокоенный
clerk -- секретарь, чиновник
to ply -- курсировать
hindrance -- помеха, препятствие
famine -- голодный
stumbling -- спотыкаясь
unhindered -- бесприпятственно
artifice -- ухищрения, хитрость, выдумка, изобретение
ashore -- на суше, на берегу
abode -- обитель, жилище
aright -- хорошо
tarry -- задерживаться, медлить, ждать
sewn -- сшитый, пришитый
fringe -- бахрома, край, кайма, окраина
rugged -- прочный, бурный, суровый, крепкий, массивный
mouth -- устье, рот, отверстие
bark -- лаять, лай
effigy -- чучело
ripe -- спелый, зрелый
meaningly -- сознательно, нарочно
forefather -- праотец, предок
hereditary -- наследственный
chaffer -- спор, торговаться, торговаться
fertile -- плодородный
irrigate -- орошать
fodder -- корм
scarcity -- нехватка, дефицит
bustling -- шумный, суетливый
donkey -- осёл
forage -- корм, фураж
infidel -- неверный
dread -- страх, бояться, страшиться, страшный
revels -- наслаждается, пирушка, празднество
pile -- куча, груда
neatly -- аккуратно, опрятно, четко
fashion -- мода, стиль, образ
loosely -- свободно
sundry -- разные
persecute -- преследовать
coax -- уговаривать, упрашивать
intruder -- злоумышленник, незванный гость, самозванец
hamlet -- деревушка
ass -- осёл, задница
hereabouts -- здесь, поблизости
flat cake -- лепёшка
riven -- расколотый
jagg -- зубец, острый выступ
yapp -- тявкать
tripped -- споткнулся
garb -- одежда
damper -- заслонка, задвижка
warily -- осторожно
unslung -- снял с плеча
sublime -- высокий, величественный
undismayed -- неустрашимый
thine -- твой
behalf -- от имени
hemmed -- подшитый, подрубленный
linen -- шерсть, белье
pitch -- смола
defile -- осквернять, загрязнять
outworn -- изношенный, изнуренный
parch -- иссушать, сушить, пересыхать
cranny -- трещина, щель
wholesome -- полезный, здоровый, безопасный
beloved -- возлюбленный, любимый
sustenance -- пропитание, поддержка
tempt -- искушать, соблазнять
unquenchable -- неугасимый, неиссякаемый
bosom -- лоно, недра
ken -- кругозор, знать
harlequin -- шут, клоун
mountebank -- шарлатан, мошенник, обманщик
cast off -- отбросить, сбрасывать, бросаться
brawl -- скандал, драка, ссора
reason -- причина, разум, рассудок
rag -- тряпка, лоскут, обрывок
endure -- терпеть, вынести
galley -- галера
gangway -- проход, мостки, трап
comely -- симпатичный, миловидный, хорошенький
tumble -- кувыркаться, падать, вываливаться
generous -- великодушно, щедрый, обильный
worship -- поклонение, боготворить
mummer -- ряженый, актер
courteous -- вежливый, учтивый
cushion -- подушка
prosecute -- преследовать по суду, обвинять, обвинитель
truce -- перемирие
penaltie -- наказание, штраф
tenure -- пребывание, владение
particularly -- особенно, в особенности, в частности
allege -- утверждать
remit -- переведён
descent -- спуск, происхождение, понижение
spoil -- портиться, трофей
utter -- произносить, полный, выражать
languish -- томиться, чахнуть, тосковать, слабеть
minister -- служить, слуга, посланник
ailment -- болезнь, недуг
frank -- откровенный, честный, искренний
therein -- там, в этом, здесь
envoy -- посланник
credential -- полномочия, мандат
plight -- тяжелое положение, состояние
behove -- подобает, следовать
inclination -- влечение, наклон, склонность
waive -- отказаться
persist -- сопротивляться, сохраняться, упорствовать
splendour -- великолепие
grope -- нащупать, искать
lattice -- решётка
peal -- звон, грохот, греметь
twain -- двое, два, пара
kindle -- зажечь, разжечь, загореть
scabbard -- ножны
gallant -- доблестный
clink -- звенеть, звон
unheed -- незамеченный, не обращать внимание
hoard -- копить, запас, хранить
tribute -- дань
acknowledgment -- подтверждение, признание
boastfulness -- хвастоство
omen -- предзнаменовение, знак, примета
moody -- капризный, угрюмый
despise -- презирать
numb -- онемевший, поражать
cloud -- облако, туча, омрачать
rebuke -- упрекать, выговор, укор
evasively -- уклончиво
repose -- отдых, покой, полагаться, держаться
aforetime -- раньше, прежде
rejoicing -- радуясь, веселье, праздник
the said -- указанный
consign -- отправлять, передавать
repossess -- вернуть во владение
hand over -- сдавать, передавать
revenues -- доходы
duly -- должным образом, правильно
attest -- свидетельствовать, подтверждать
revictualled -- возобновлено продовольствием
excellency -- превосходительство
present -- представлять, присутствующий
nun -- монахиня
crucifix -- распятие
pray -- молиться, просьба, просить
Gospels -- Евангелие
byword -- притча, символ
hollow -- пустой, полый, впадина, углубление
account -- счет, расчёт
reft -- назад, похищать
imperturbable -- невозмутимый, спокойный
perverse -- извращенный, порочный, упрямый
marplot -- заговор
pomp -- великолепие, пышность
extremity -- конечность, крайность, чрезмерность
circus -- цирк, амфитеатр
anoint -- помазать, смазывать
eloquence -- красноречие
lavish -- щедрый, расточать, обильный
poise -- уравновешенность, равновесие, держать, готовый
forgery -- подделка, подлго, фальсификация
heedless -- беззаботный, невнимательный
beam -- луч
whithersoever -- где угодно
bodkin -- шило, кинжал
estimate -- оценивать, оценка
vicissitude -- превратности судьбы, перемена
nothingness -- ничто, небытие
enmesh -- опутывать, запутывать
augury -- предзнаменовение, предсказание
post -- должность
injurie -- травма
slander -- клевета, злословие, лгать
pregnant -- беременная, полный смысла, содержательный
confer -- назначить, присваивать
submit -- представлять на рассмотрение, подавать, утверждать
spinning -- прядение
martyrdom -- мученичество
fulfill -- выполнить, исполнять, осуществлять
entomb -- погребать, укрывать