Биік --  Высокий 
Fласа-- низкий
Үлкен -- Большой
Кішкентай -- маленький
Ыстық -- Горячий 
Суық -- холодный
Ауыр -- Тяжёлый (трудный) 
Жеңіл -- лёгкий
Алыс -- Далеко
Жақын -- близко
Жақсы -- Хорошо
Жаман -- плохо
Арзан -- Дешёвый
Қымбат -- дорогой

Отан -- Родина
Қорғау -- Защита
Сарбаз -- Солдат
Ар -- Честь
Ерлік -- Мужество
Даңқ -- Слава
Батыр -- Герой
Жауынгер -- Воин
Еңбек -- Труд
Отансүйгіштік -- Патриотизм

Теңіз -- море
Жел -- ветер
Ауа -- воздух
Жағажай -- Пляж

ілгерілеу, даму, өсу -- прогресс

Табыс -- прибыль, доход
Салық -- налог
Жалақы -- оклад, зарплата
Шығын -- расход
Қарыз -- долг
Салым -- вклад, инвестиция
Іс-шара -- мероприятие, деловое событие
Кеңес -- совет, рекомендация
Нарық -- рынок

Қуаныш -- Радость
Махаббат -- Любовь
Ренжу -- Обида
Қорқыныш -- Страх
Қайғы -- Грусть
Өкініш -- Сожаление
Намыс -- Гордость 
Мейірім -- Доброта
Таңдану -- Удивление
Күмән -- Сомнение
Ұят  -- Стыд

өсімдік -- растение
құс -- птица
есіңе сақта -- запомни
арнайы -- специальный
жаттығу -- упражение
мақал -- пословица
қасық -- ложка
мүсін -- бюст
уәде -- обещание
қола -- бронза, бронзовый
әдепті -- вежливый, воспитанный
ағаш -- дерево, деревянный
алқа -- ожерелье
ақылды -- умный
қаһаз -- бумага
кұмыра -- кувшин, ваза
шаңғы -- лыжи
сәуле -- луч, сияние
төр -- почетное место
көніл -- настроение
ақыл -- ум
ер -- жигит, воин
ғарышкер -- косманавт
қалың -- толстый, сильный
кәрі -- старый
гауһар -- алмаз, бриллиант
ұл -- сын, мальчик
үлгі -- образец
ұстаз -- учитель
іскер -- мастер, деловой
қайың -- береза
сағыз -- жвачка
жаңбыр -- дождь
жел -- ветер
бұлт -- облако, туча
шаһар -- город
дауыл -- буря
бұршақ -- град
құйын -- смерч
тасқын -- наводнение
толқын -- волна
сел -- сель
шөп -- трава
гүлзар -- цветник, клумба
көбелек -- бабочка
Жаман емес -- неплохо
күншығыс -- восток
күнбатыс -- запад
бол -- живой, давай
бөл -- дели, раздели
ғұлама -- мудрец, мудрый
елші -- посол
ғажайып -- восхитительно, удивительно, удивительный
дәм -- вкус
қысу -- зажать, давить
көкөніс -- овощи
сәбіз -- морковь
пияз -- лук
сиыр еті -- говядина
асқабақ -- тыква
мейіз -- изюм
өрік -- урюк
қажетті -- необходимый
қырыққабат -- капуста
сары -- желтый
қымбат -- дорого, дорогой
қанша тұрады -- сколько стоит?
сатып аламын -- буду покупать, я куплю
өлшеңіз -- взвесьте
бара жатырмын -- я иду
алғыс -- благодарность
арзан -- дешево, дешеый
салып беріңіз -- положите
қораз -- петух
шөже -- цыпленок
қаз -- гусь
үйрек -- утка
көгершін -- голубь
өгіз -- бык
түйе -- верблюд
күшік -- щенок
құлын -- жеребенок
түлкі -- лиса
қасқыр -- волк
маймыл -- обезьяна
бұғы -- лось
ақбөкен -- сайгак
керік -- жираф
киік -- сайгак
алыс -- далеко
кең -- широко, широкий
арық -- худой
қу -- хитрец, хитрый
мыршай -- лисенок
кірпі -- еж
мағынасы -- значение
іш -- омонимы: живот, пей, внутренность
тар -- тесный
ұзын -- длинный
қысқа -- короткий
қиын -- трудный
оңай -- легкий
жирен -- рыжий, брезгуй
сыр -- краска, тайна
сүз -- бодай, веди
от -- огонь, правда
жаға -- берег, воротник
етістік -- глагол
тыңдап тұрмын -- я вас слушаю
онда -- тогда
келесі жолы -- в следующий раз
қарлығаш -- ласточка
торғай -- воробей
аққу -- лебедь
тырна -- журавль
қырғауыл -- фазан
үкі -- сова
қарға -- ворона
сауысқан -- сорока
найзағай -- молния
ауыр -- тяжелый, тяжело
әкелдіңіз (әкелу) бе? -- принесли (принести) ли?
рұқсат па? -- можно, разрешите
шағала -- чайка
шақпақ -- спички
ғарыш -- космос
ірімшік -- творог
шанышқы -- вилка
пышақ -- нож
күлсалғыш -- пепельница
таңдады -- выбрал
шарап -- вино
шырын -- сок
әрі -- еще, а также
қарын -- живот, брюхо
Мен қазақша ептеп білемін -- я немного говорю по-казахски
Мен қазақ тілін түсінемін (түсінбеймін) -- я понимаю (не понимаю) казахский язык
Мен қазақша үйреніп жүрмін -- я учу казахский язык.
бор -- мел
сызғыш -- линейка
тақта -- доска
түбір -- корень
тілдескіш -- разговорник
жалғау -- окончание, соединить, прибавить
ем -- лечение
тәрбие -- воспитание
тәрбиеші -- воспитатель
мейманхана -- гостиница
көрме -- выставка
емхана -- поликлиника
мұражай -- музей
хатшы -- секретарь
би (биші) -- танец (танцор)
көрші-қолаң -- соседи
қарым-қатынас -- взаимотношения
бала-шаға -- домочадцы
келін-кепшік -- снохи, невесты
оқта-текте -- иногда
оқтын-оқтын -- временами
қайта-қайта -- снова и снова
әрең-әрең -- еле-еле
сап-сары -- желтее
әп-әдемі -- красивее
жидек -- ягода
жеміс -- фрукты
жекпе-жек -- один на один
қып-қысқа -- очень короткий
шелек-шелек -- ведро
қап-қап -- мешок
жиі-жиі -- часто-часто
жұмыс істейді -- работает
қуаныш -- радость
шашу -- разбрасывать, рассыпать транжирить
астық -- зерно, пшеница, урожай
шықты -- вышел
аурухана -- больница
жауып тұр (жауады) -- идет (пойдет) снег/дождь
әрең -- едва, кое-как
Жез + қазған -- медь + копал
Ақ + төбе -- белый + холм
Талды + қорған -- лесистый + курган
Әкел (алып + кел) -- принеси (возьми + приди)
Апар (алып + бар) -- отнеси (возьми + иди)
түйеқұс -- страус
құтан -- цапля
қарақұс -- могильник, коршун
тасбақа -- черепаха
қырықаяқ -- сороконожка
күнбағыс -- подсолнух
қырықбуын -- гусеница
қозықұйрық -- гриб сморчок
емдік -- лечебный
қаз -- гусь
шатыр (-лы) -- крыша (с крышой)
перде -- шторы
бөлме -- комната
айна -- зеркало
қабырға -- стена
ас үй -- кухня
дәліз -- прихожая
аспашам -- люстра
іліну (ілінген) -- висеть, повиснуть, уцепиться (висит)
төселген (төсеу) -- застеленный (стелить)
жарық -- свет, трещина, ярко, яркий
құрдас -- ровесник
кесене -- мавзолей
тұру (тұрады, турамын) -- жить, стоять (живет, живу, постою, встану)
айлық -- зарплата
тұған -- родной
мән -- значение, смысл
ойыншық -- игрушка
ұщқыш -- летчик
алыс емес -- недалеко
көру (көремін, көрді) -- видеть, (вижу, видел)
дайын -- готов, готовый
ерін -- губы
баяндама -- доклад
тақырып -- тема
боу (болған, болды) -- быть (был)
келу (келеді, келді, келген) -- прийти, прибыть, приезжать (приехать)
бару (барады, барды) -- ехать, идти (пойдет, пошел)
қарасөз -- проза, назидание
далап -- помада
жағамын -- накрашу
отыр (у) -- сидит, сядь (сидеть)
жүр (у) -- ходит, иди (ходить)
жатыр -- лежит
үйрену -- научиться
аға -- старший брат
іні -- младший брат
әпке -- старшая сестра
қарындас -- младшая сестра
алау -- костер, огонь, пламя, факел
бұзылу -- портиться, повреждение, развалиться, расстройство, гниение
жазу -- письмо
жазушы -- писатель
етік -- сапог
етікші -- сапожник
жол -- дорога
жолдас -- друг
ат -- имя
аттас -- люди с одинаковыми именами
қызмет -- служба, работа
қызметкер -- служащий
кес -- режь
кеспе -- лапша
тоқы -- вяжи
тоқыма -- трикотаж
бас -- печатай
баспа -- издательство
сүз -- цеди
сүзбе -- творог
бөл -- дели
бөлім -- отдел
таны -- узнай
таным -- познание
бас -- наступи
басқыш -- ступнька, лестница
ұш -- лети
ұшқыш -- летчик
сүз -- сцеди
сүзгіш -- фильтр
тану -- узнать
батырлық -- мужество
жерлес -- земляк
теңіз -- море
алмүрт -- груша
ем -- лечение
көше -- улица
мейман -- гость
дәрі -- лекарство
жазба -- письменный
тәрбие -- воспитание
үшақ -- самолет
мұхит -- океан
Кезектің соңы кім? -- Кто последний?
Кімнің кезегі? -- Чья очередь?
Қандай қызмет көрсетейік -- Какой услугой вы хотели бы воспользоваться?
Сізді тыңдап тұрмын -- Я вас слушаю
Сізге ұнады ма? -- Вам понравилось?
бекіре -- осетр
шортан -- щука
жайын -- сом
табан -- лещ
емен -- дуб
терек -- тополь
қарағай -- сосна
шырша -- ель, елка
өтінемін (өтіну) -- прошу (просить)
жүзім -- виноград
жапалақ -- сова
арша -- арча, вереск
тырнақ -- ногти
әсем (әсемдік) -- красивый (красота, изящество)
ұнады (ұнау) -- понравилось (нравиться)
биік -- высокий
аласа -- низкий
тәтті -- сладкий
жалпақ -- плоский
домалақ -- круглый
әл -- сила
тұз -- соль
кішкене -- маленький
қатты -- твердый, жесткий
сопақ(ша) -- продолговатый
күн күркіреді (күркіреу) -- гремит гром (греметь)
момын -- скромный
томпақ -- выпуклый, выступ
тентек -- шалун, озорной
ащы -- горький, острый
тұщы -- пресный
кышқыл -- кислый
түзу -- прямой, ровный
қисық -- кривой, ровный
дөңгелек -- колесо, круг, круглый
жалқау -- лентяй, ленивый
жұмсақ -- мягкий
баспасөх -- периодика
тау етегі -- подножие горы
шетел -- граница, зарубежный
кірпік -- ресница
қауын -- дыня
жақын -- близко
қатар -- ряд
орналасқкан (орналасу) -- расположен, находится (устроиться, заселиться)
басқа -- другой, иной, кроме, отдельно, прочий
толық -- полный, толстый, полностью, целый, сполна
қосі -- сложить
алу -- вычесть
көп -- больше
аз -- меньше
тең -- равно
көбейту -- умножить
бөлу -- разделить
қосынды -- сумма
бөлшек -- дробь
жарты -- половина
бүтін -- целое
жұп сан -- четное число
тақ сан -- нечетное число
тор -- сетка, паутина
тор көз -- в клеточку
айтыңызшы -- скажите
кетті -- прошло
қалды -- остался
қадам -- шаг
кедей -- бедный
кедейлік -- бедность
құтты -- удачливый
сан -- число, количество
сынып -- класс
өркеш -- верблюжий горб, холка
топ -- группа
үздік -- отлично, отличник, передовой
оның -- из них, его
өткен -- прошедкий, бывший, прошлый
алды (алу) -- взял, брал, получил
құрылды (құрылу) -- образовался, создался
ежелгі -- древний
шығыс -- восток, восход, расход
ұзын жол -- в линейку
шетінде (шеті) -- на краю (край)
жүзіп жүр (жүзу) -- плывет, плавает (плавать)
кейін -- после, за
шағын -- небольшой, незначительный
мөлшермен (мөлшер) -- в пределах (норма, доза)
бөлігі (бөлік) -- доля, раздел, часть
құрылтай -- съезд
мәселе -- вопрос, проблема
қатысты (қатысу) -- присутствовал, участвовал (участвовать)
құрайду (құрау) -- составляет (составлять, собрать)
арналған (арналу) -- посвященный (посвящаться)
мақтайды (мақтау) -- хвалит (хвалить)
мақтамайды -- не хвалит
дәуір -- период
мәдени -- культурный
атап өтейік (атап өту) -- отметим (отпраздновать)
ғасыр -- век
ескерткіш -- памятник
жеткен (жету) -- дошедший (добраться)
енгізілген (енгізілу)  -- внесен(ный), введен(ный) (внердить, включить)
әрбір -- каждый 
бәрі -- все 
барлық -- весь
түгел -- полностью
әркім -- каждый, относительно к человеку)
біреу, кейбіреу, әлдекім -- кто-то 
бірдеме -- что-то 
әлдеқандай -- какой-то
әлдеқайда -- где-то, куда-то
әлдеқашан -- когда-то
бірнеше -- несколько
біраз -- немного
кейбір -- некоторый
ешкім -- никто
ештеме, ештеңе -- ничего
ешқандай -- никакой
ешқашан -- никогда
ешқайда -- никуда
ешқалай -- никак
туысқан -- родственник
қысқару -- сокращаться
тоқтау (тоқтапты) -- остановиться (остановился)
кездесу -- встреча, встретиться
қыдырды (қыдыру) -- гулял (гулять, бродить)
аула -- двор
өсіру -- растить
қызанақ -- помидор
қияр -- огурец
ұзару -- удлиниться
қызылша -- свекла
сарымсақ -- чеснок
көлік -- транспорт, машина
енду -- теперь